20162081,789,835,935,937,969,1720,6185,1
20160955,775,831,934,939,973,1719,6171,2
20160254,785,825,929,940,971,1719,6169,3
20160238,789,829,935,940,969,1700,6162,4
20160940,785,824,933,936,973,1708,6159,5
20160514,781,825,944,942,973,1693,6158,6
20160575,786,831,929,940,954,1714,6154,7
20160880,792,837,942,924,959,1693,6147,8
20162008,790,826,925,936,961,1709,6147,9
20160822,787,828,925,938,972,1696,6146,10
20160334,787,824,938,938,972,1686,6145,11
20160292,785,824,926,930,972,1706,6143,12
20160606,781,822,939,940,955,1706,6143,13
20160491,790,822,927,936,959,1707,6141,14
20162019,771,827,936,940,969,1688,6131,15
20160495,788,826,927,931,960,1691,6123,16
20160949,778,813,930,939,969,1694,6123,17
20160875,778,830,923,936,965,1687,6119,18
20160345,757,810,935,938,970,1708,6118,19
20160959,783,826,928,932,958,1688,6115,20
20150711,771,823,920,926,967,1708,6115,21
20160142,768,820,943,933,965,1685,6114,22
20160764,770,798,931,941,966,1705,6111,23
20160597,779,814,927,931,959,1699,6109,24
20162061,782,818,928,943,945,1689,6105,25
20160553,777,831,919,937,956,1680,6100,26
20162064,758,777,931,940,975,1713,6094,27
20160846,775,824,916,934,962,1681,6092,28
20160155,779,824,913,927,963,1676,6082,29
20162063,782,830,905,915,960,1686,6078,30
20160417,764,818,919,921,954,1700,6076,31
20161933,729,823,916,930,964,1714,6076,32
20160166,774,824,916,934,948,1675,6071,33
20160954,767,804,917,936,962,1685,6071,34
20160453,781,813,906,934,952,1683,6069,35
20160028,752,804,917,934,942,1717,6066,36
20160802,774,801,907,925,942,1717,6066,37
20161930,754,838,920,920,943,1689,6064,38
20160306,763,807,918,925,950,1698,6061,39
20160960,772,819,920,919,946,1683,6059,40
20160177,721,828,927,939,963,1679,6057,41
20160870,760,804,929,932,945,1687,6057,42
20160901,771,789,897,935,958,1707,6057,43
20161052,725,821,931,932,959,1688,6056,44
20160638,769,817,918,936,942,1672,6054,45
20160539,771,814,917,937,938,1675,6052,46
20162082,784,817,925,935,950,1641,6052,47
20160289,747,817,923,924,949,1689,6049,48
20162054,755,819,917,929,944,1685,6049,49
20162066,761,803,905,941,951,1687,6048,50
20160320,768,818,913,914,944,1687,6044,51
20162059,730,820,929,936,964,1663,6042,52
20160804,763,813,898,927,921,1715,6037,53
20162080,739,810,925,941,958,1661,6034,54
20162068,785,827,918,917,915,1668,6030,55
20160924,770,818,896,922,953,1669,6028,56
20162065,778,818,924,935,935,1636,6026,57
20160589,784,801,908,924,936,1670,6023,58
20162073,760,806,915,935,952,1654,6022,59
20160364,775,811,908,929,917,1679,6019,60
20160319,752,818,897,930,944,1677,6018,61
20160603,770,813,913,932,918,1669,6015,62
20162072,752,789,926,935,956,1657,6015,63
20160318,757,813,923,923,934,1662,6012,64
20160290,762,814,926,931,921,1656,6010,65
20160429,753,800,890,929,954,1684,6010,66
20160358,750,794,907,931,934,1693,6009,67
20160242,755,804,895,929,940,1685,6008,68
20160472,747,796,897,916,939,1713,6008,69
20160707,729,798,899,929,952,1701,6008,70
20160075,781,812,902,922,943,1645,6005,71
20160271,763,806,920,923,936,1657,6005,72
20160751,781,823,899,921,937,1644,6005,73
20160937,763,804,864,928,959,1687,6005,74
20160009,774,806,888,916,926,1694,6004,75
20160969,738,821,922,921,941,1660,6003,76
20162032,755,810,914,926,934,1664,6003,77
20160662,771,813,908,916,931,1657,5996,78
20160031,761,828,907,906,927,1666,5995,79
20162024,780,798,879,923,942,1672,5994,80
20160788,748,782,903,913,935,1712,5993,81
20160639,773,819,916,919,942,1623,5992,82
20160482,765,821,906,919,917,1663,5991,83
20160722,766,820,924,932,931,1616,5989,84
20160137,776,802,892,919,958,1641,5988,85
20160854,779,812,898,925,943,1631,5988,86
20160689,749,808,892,932,933,1673,5987,87
20162044,751,810,901,923,936,1666,5987,88
20160679,781,814,882,915,912,1681,5985,89
20160438,747,808,904,914,920,1688,5981,90
20161111,710,809,914,928,937,1682,5980,91
20162060,764,784,898,930,940,1664,5980,92
20160245,754,793,889,922,940,1680,5978,93
20160516,770,808,919,915,920,1645,5977,94
20161814,718,788,900,925,956,1689,5976,95
20162020,730,779,871,926,960,1708,5974,96
20161071,677,798,922,942,956,1677,5972,97
20160630,739,792,913,929,933,1664,5970,98
20160761,755,799,906,912,929,1668,5969,99
20160673,732,770,904,927,948,1686,5967,100
20162023,765,806,900,916,910,1669,5966,101
20160170,777,812,896,910,922,1648,5965,102
20160664,727,784,893,934,947,1679,5964,103
20160792,734,799,894,926,941,1669,5963,104
20160295,750,807,894,922,924,1664,5961,105
20160666,760,812,889,934,918,1648,5961,106
20160542,759,817,926,925,924,1609,5960,107
20162014,764,804,909,932,930,1621,5960,108
20160571,757,804,905,921,955,1617,5959,109
20160895,762,789,901,930,913,1664,5959,110
20160766,758,804,900,901,933,1662,5958,111
20162030,751,815,919,932,913,1628,5958,112
20160942,770,769,870,902,952,1691,5954,113
20161042,755,817,913,912,914,1643,5954,114
20160885,780,806,892,904,907,1663,5952,115
20162108,745,809,875,911,954,1657,5951,116
20160130,756,791,883,923,928,1669,5950,117
20162055,783,824,862,928,899,1654,5950,118
20161025,763,813,916,932,927,1595,5946,119
20160010,772,801,898,918,907,1649,5945,120
20160678,752,778,892,922,916,1682,5942,121
20160247,743,789,897,923,917,1672,5941,122
20160069,775,804,913,915,906,1627,5940,123
20160181,754,794,899,909,917,1664,5937,124
20160964,765,791,904,914,914,1649,5937,125
20160688,720,779,875,924,951,1679,5928,126
20160576,755,767,859,927,938,1680,5926,127
20160451,763,788,882,924,933,1633,5923,128
20160684,773,755,875,914,933,1673,5923,129
20160686,751,760,902,917,936,1657,5923,130
20160161,746,797,883,914,915,1666,5921,131
20160754,763,809,857,918,912,1661,5920,132
20160015,740,797,921,919,894,1648,5919,133
20160694,736,781,891,919,941,1650,5918,134
20160687,721,762,891,923,944,1676,5917,135
20160907,713,779,907,918,947,1651,5915,136
20160178,744,796,872,910,937,1654,5913,137
20160046,746,778,881,912,919,1676,5912,138
20160445,729,786,889,920,934,1652,5910,139
20160108,736,795,894,910,915,1657,5907,140
20160469,763,801,891,924,903,1624,5906,141
20161903,687,780,881,918,952,1687,5905,142
20160867,742,790,870,917,932,1653,5904,143
20161909,721,783,879,919,956,1646,5904,144
20160338,755,799,883,899,921,1646,5903,145
20160007,749,754,920,874,942,1662,5901,146
20160382,748,797,843,925,936,1652,5901,147
20160874,763,795,882,912,926,1623,5901,148
20160896,738,794,887,921,943,1618,5901,149
20160961,769,785,889,898,923,1636,5900,150
20160065,754,800,872,910,911,1652,5899,151
20160415,712,808,903,909,906,1661,5899,152
20160710,760,791,901,897,910,1640,5899,153
20160680,747,788,900,911,895,1657,5898,154
20162003,747,805,897,885,897,1667,5898,155
20160777,705,763,873,914,956,1685,5896,156
20160546,759,792,866,910,930,1637,5894,157
20160308,740,810,885,926,903,1627,5891,158
20162087,764,814,859,909,949,1596,5891,159
20160333,737,781,884,929,936,1623,5890,160
20160339,744,806,853,923,945,1619,5890,161
20160507,746,797,884,907,906,1650,5890,162
20160564,612,809,917,933,921,1698,5890,163
20160585,750,779,905,872,933,1651,5890,164
20160607,714,790,901,914,916,1654,5889,165
20162015,755,797,882,902,941,1612,5889,166
20160632,744,799,888,919,908,1629,5887,167
20160925,741,796,889,920,935,1603,5884,168
20160122,775,818,913,911,897,1568,5882,169
20160844,765,783,857,920,921,1635,5881,170
20160257,773,795,877,921,903,1611,5880,171
20160378,766,793,876,915,914,1615,5879,172
20160280,729,778,882,913,934,1640,5876,173
20160220,693,778,872,927,944,1661,5875,174
20160832,745,799,876,898,918,1639,5875,175
20160270,774,810,910,911,872,1594,5871,176
20160367,712,810,912,922,900,1611,5867,177
20160917,766,781,859,904,932,1625,5867,178
20160888,751,806,876,904,910,1619,5866,179
20161931,753,770,865,911,935,1632,5866,180
20160757,732,767,870,895,910,1691,5865,181
20160894,750,791,894,907,915,1607,5864,182
20160703,704,772,905,907,927,1648,5863,183
20161905,725,779,840,901,952,1666,5863,184
20162052,724,788,888,914,922,1627,5863,185
20160912,740,790,863,916,941,1611,5861,186
20160921,734,764,891,912,902,1656,5859,187
20160588,769,769,833,888,931,1667,5857,188
20160826,723,797,869,881,914,1673,5857,189
20160796,702,767,896,916,915,1659,5855,190
20160381,733,766,888,917,908,1640,5852,191
20160645,781,780,868,901,905,1617,5852,192
20162022,763,646,918,927,911,1687,5852,193
20160165,767,805,834,919,889,1637,5851,194
20160185,752,762,868,901,926,1641,5850,195
20160690,780,805,876,898,878,1612,5849,196
20160255,765,800,899,912,859,1609,5844,197
20160466,705,782,888,918,917,1632,5842,198
20160503,749,774,883,917,909,1610,5842,199
20160871,716,750,907,908,919,1639,5839,200
20160080,727,788,880,885,910,1646,5836,201
20162033,743,817,890,887,893,1602,5832,202
20160239,751,750,883,921,896,1628,5829,203
20161060,698,755,896,924,940,1615,5828,204
20160691,687,789,880,916,924,1631,5827,205
20160330,717,782,890,902,921,1614,5826,206
20160037,746,790,881,911,904,1590,5822,207
20162041,695,742,887,927,955,1616,5822,208
20160328,759,780,842,889,914,1634,5818,209
20160865,728,810,904,910,901,1565,5818,210
20161906,750,746,875,920,935,1592,5818,211
20162038,765,811,922,921,868,1529,5816,212
20160437,737,760,881,911,914,1612,5815,213
20160200,753,796,905,922,882,1556,5814,214
20160368,672,750,890,919,936,1647,5814,215
20160637,731,777,841,913,898,1653,5813,216
20160845,654,775,888,908,934,1654,5813,217
20161908,705,773,844,901,929,1659,5811,218
20160435,761,796,879,915,886,1573,5810,219
20160106,764,764,825,899,905,1650,5807,220
20160681,715,739,859,909,933,1649,5804,221
20160591,731,770,856,911,909,1626,5803,222
20160443,765,759,848,918,891,1620,5801,223
20160354,694,760,888,920,925,1613,5800,224
20161922,679,786,869,887,917,1660,5798,225
20160615,737,771,876,899,866,1647,5796,226
20160470,732,779,894,892,889,1609,5795,227
20160519,753,764,890,899,904,1585,5795,228
20160392,733,757,879,910,907,1608,5794,229
20160741,738,757,866,907,895,1630,5793,230
20160903,753,736,868,911,897,1627,5792,231
20160221,743,740,850,910,920,1627,5790,232
20160422,753,789,894,892,866,1596,5790,233
20160459,744,790,846,896,871,1642,5789,234
20160281,740,778,852,880,877,1661,5788,235
20160648,747,768,815,909,935,1614,5788,236
20160246,711,719,861,921,913,1662,5787,237
20160700,716,762,863,901,907,1636,5785,238
20160228,570,735,903,929,959,1688,5784,239
20160634,663,778,840,883,917,1702,5783,240
20161836,722,765,829,901,941,1624,5782,241
20161829,659,726,876,902,949,1668,5780,242
20162035,746,756,877,894,908,1597,5778,243
20160653,759,750,842,894,912,1620,5777,244
20160153,725,775,820,879,903,1674,5776,245
20160463,689,788,846,911,913,1629,5776,246
20160833,756,802,808,857,905,1648,5776,247
20160176,748,767,852,914,908,1583,5772,248
20161901,672,758,828,905,944,1665,5772,249
20161819,753,790,895,912,840,1581,5771,250
20160128,690,778,877,911,895,1618,5769,251
20160556,729,745,861,879,890,1665,5769,252
20162046,748,779,823,914,902,1600,5766,253
20160550,672,741,865,910,935,1642,5765,254
20160752,699,757,851,910,894,1652,5763,255
20161820,754,777,871,906,874,1581,5763,256
20160493,708,746,843,918,927,1619,5761,257
20160562,737,738,853,900,890,1643,5761,258
20160082,751,784,852,874,879,1620,5760,259
20160705,768,713,810,900,934,1635,5760,260
20160762,722,775,829,897,926,1611,5760,261
20160884,724,743,824,908,917,1642,5758,262
20160322,707,799,898,914,876,1561,5755,263
20160447,740,784,883,896,875,1577,5755,264
20160465,705,747,856,908,895,1644,5755,265
20160706,684,755,858,888,926,1644,5755,266
20161029,738,785,871,893,870,1596,5753,267
20162071,705,806,896,914,870,1561,5752,268
20160608,733,773,844,896,910,1592,5748,269
20160951,742,793,864,884,849,1616,5748,270
20160970,711,782,898,898,900,1559,5748,271
20161921,712,785,858,900,902,1591,5748,272
20160243,745,772,825,887,899,1618,5746,273
20160473,672,770,887,880,869,1662,5740,274
20162096,684,748,867,917,884,1639,5739,275
20160835,732,738,802,878,922,1665,5737,276
20160533,732,756,812,894,927,1615,5736,277
20160740,769,772,822,864,901,1606,5734,278
20161816,734,786,876,872,910,1556,5734,279
20162031,728,799,894,902,895,1515,5733,280
20161068,656,787,882,896,905,1605,5731,281
20160049,685,750,881,902,895,1616,5729,282
20160323,678,768,895,902,930,1556,5729,283
20162088,723,752,844,891,903,1616,5729,284
20160235,708,703,812,899,954,1651,5727,285
20162018,725,747,845,909,893,1608,5727,286
20161927,683,741,860,896,895,1651,5726,287
20160587,685,693,858,928,907,1652,5723,288
20161810,748,774,839,890,892,1580,5723,289
20160773,665,763,818,874,914,1688,5722,290
20160643,753,703,809,905,911,1640,5721,291
20160701,667,771,857,913,884,1629,5721,292
20160408,688,721,833,919,916,1643,5720,293
20160041,777,796,860,895,810,1581,5719,294
20160789,715,704,870,920,873,1635,5717,295
20162045,671,769,859,901,941,1575,5716,296
20160697,746,738,835,896,896,1603,5714,297
20160213,653,697,834,923,938,1668,5713,298
20160101,722,797,835,904,863,1590,5711,299
20160717,757,779,808,891,891,1585,5711,300
20160931,728,742,855,894,888,1601,5708,301
20160869,737,763,787,881,898,1640,5706,302
20160914,707,756,878,883,876,1606,5706,303
20160948,735,736,802,905,863,1665,5706,304
20160211,747,736,803,890,905,1624,5705,305
20160497,706,772,806,912,940,1569,5705,306
20160941,678,736,824,894,926,1647,5705,307
20160355,729,769,853,876,875,1602,5704,308
20160610,630,787,888,897,887,1615,5704,309
20160505,702,742,837,897,908,1617,5703,310
20160952,754,769,856,888,844,1592,5703,311
20160428,679,752,884,883,889,1615,5702,312
20160070,723,777,859,888,881,1573,5701,313
20160483,723,743,850,875,888,1622,5701,314
20160293,703,755,853,883,914,1592,5700,315
20160755,649,753,834,900,929,1634,5699,316
20160938,774,790,793,864,923,1555,5699,317
20161821,704,774,834,889,888,1608,5697,318
20160899,723,742,842,910,898,1581,5696,319
20161915,696,755,776,887,920,1661,5695,320
20160479,730,738,786,904,899,1637,5694,321
20160087,730,767,841,871,885,1599,5693,322
20161051,710,799,875,896,866,1547,5693,323
20160325,692,772,790,915,920,1603,5692,324
20160860,724,724,790,896,918,1635,5687,325
20160078,739,761,781,878,880,1647,5686,326
20160492,720,778,829,888,864,1607,5686,327
20162083,721,764,864,914,888,1535,5686,328
20160003,724,729,854,881,870,1626,5684,329
20160560,719,715,835,890,900,1622,5681,330
20162079,696,751,816,894,875,1649,5681,331
20160241,676,754,844,889,893,1623,5679,332
20161912,723,745,843,898,876,1594,5679,333
20162010,746,785,862,901,854,1530,5678,334
20161050,701,756,849,893,916,1562,5677,335
20160251,679,772,835,912,886,1591,5675,336
20160136,707,797,841,896,916,1517,5674,337
20160231,763,776,715,907,900,1613,5674,338
20160760,734,719,842,892,871,1616,5674,339
20160913,736,767,863,890,843,1575,5674,340
20160195,644,759,857,903,874,1636,5673,341
20161838,589,718,864,925,898,1679,5673,342
20160732,660,753,838,894,896,1630,5671,343
20160222,690,767,916,891,834,1568,5666,344
20162009,681,764,840,917,884,1580,5666,345
20162056,706,747,822,876,913,1601,5665,346
20162058,744,776,852,873,863,1557,5665,347
20160720,695,726,826,898,923,1596,5664,348
20160302,745,735,819,894,872,1596,5661,349
20161832,736,714,816,855,897,1643,5661,350
20161835,680,662,828,890,925,1676,5661,351
20160261,709,753,836,908,882,1572,5660,352
20160234,689,719,885,879,875,1611,5658,353
20160605,682,755,862,852,899,1608,5658,354
20160282,710,726,821,900,880,1620,5657,355
20160521,691,782,875,886,861,1562,5657,356
20160614,731,706,862,897,841,1619,5656,357
20160657,744,784,800,879,844,1605,5656,358
20160383,663,754,825,898,892,1621,5653,359
20160478,706,746,848,902,837,1614,5653,360
20160249,719,775,840,902,859,1557,5652,361
20160577,690,762,833,890,877,1597,5649,362
20160771,692,728,781,888,929,1631,5649,363
20161845,676,736,834,882,924,1597,5649,364
20160676,712,709,831,881,888,1627,5648,365
20162027,754,779,835,910,842,1528,5648,366
20160910,769,795,831,876,856,1519,5646,367
20161031,760,788,851,874,852,1518,5643,368
20162007,644,779,848,887,888,1596,5642,369
20160262,725,776,885,912,851,1490,5639,370
20160523,618,735,854,892,886,1652,5637,371
20160114,696,751,848,900,876,1563,5634,372
20160850,688,763,843,890,926,1524,5634,373
20160079,760,784,850,829,803,1607,5633,374
20160131,636,644,855,873,937,1687,5632,375
20160559,645,751,859,892,840,1645,5632,376
20160359,691,760,852,895,862,1569,5629,377
20160600,701,753,875,903,841,1552,5625,378
20160269,658,746,816,902,895,1607,5624,379
20160496,668,765,853,904,872,1562,5624,380
20160759,703,781,881,851,818,1588,5622,381
20162062,664,747,838,912,874,1586,5621,382
20162029,685,688,853,888,911,1595,5620,383
20162085,649,706,824,886,918,1636,5619,384
20160663,730,761,858,905,859,1505,5618,385
20160154,716,753,834,883,852,1579,5617,386
20160132,611,721,820,904,919,1641,5616,387
20161815,699,757,865,881,884,1529,5615,388
20162053,662,669,824,896,917,1646,5614,389
20160012,744,745,808,879,853,1584,5613,390
20160223,687,762,801,895,879,1589,5613,391
20160464,648,673,785,908,932,1666,5612,392
20160244,736,725,809,900,853,1587,5610,393
20160356,738,782,848,896,850,1496,5610,394
20160086,742,790,881,877,762,1556,5608,395
20162050,705,737,779,892,885,1610,5608,396
20160209,648,752,841,904,867,1594,5606,397
20160786,738,763,846,873,826,1560,5606,398
20160387,709,740,763,899,898,1596,5605,399
20161910,641,751,809,880,892,1632,5605,400
20160644,639,712,819,910,889,1634,5603,401
20160862,707,738,798,906,874,1579,5602,402
20160823,661,783,841,871,875,1570,5601,403
20160148,611,748,871,905,900,1564,5599,404
20161831,707,759,843,881,870,1538,5598,405
20160784,722,756,834,889,842,1554,5597,406
20162075,671,717,825,893,888,1602,5596,407
20160618,570,765,863,914,890,1593,5595,408
20161822,698,736,809,874,878,1594,5589,409
20160179,636,732,842,902,878,1598,5588,410
20161852,622,732,863,883,893,1593,5586,411
20160227,640,738,846,869,905,1587,5585,412
20160508,739,731,816,890,864,1544,5584,413
20160360,689,759,826,870,844,1595,5583,414
20161913,693,764,781,899,876,1570,5583,415
20160365,713,786,873,877,886,1447,5582,416
20161847,684,684,842,890,900,1582,5582,417
20161925,633,728,763,904,899,1651,5578,418
20160395,665,757,852,894,843,1566,5577,419
20160898,648,712,869,894,926,1528,5577,420
20160847,742,775,857,888,786,1527,5575,421
20161916,694,730,876,903,816,1555,5574,422
20160018,678,690,768,889,894,1654,5573,423
20161907,686,731,797,888,916,1552,5570,424
20160331,686,734,800,901,908,1540,5569,425
20160891,565,724,791,904,926,1659,5569,426
20160366,676,732,807,898,873,1578,5564,427
20160391,725,771,803,856,824,1583,5562,428
20160768,595,682,830,914,916,1625,5562,429
20160468,617,681,828,888,904,1641,5559,430
20160119,692,733,822,893,893,1524,5557,431
20160499,558,764,840,913,891,1591,5557,432
20160746,750,755,815,882,823,1531,5556,433
20161929,663,724,845,867,850,1607,5556,434
20160442,649,694,796,903,895,1618,5555,435
20160089,585,756,848,889,885,1591,5554,436
20161809,671,712,875,893,853,1548,5552,437
20161024,691,776,855,866,831,1532,5551,438
20160743,720,716,800,892,912,1510,5550,439
20161032,743,782,793,861,799,1572,5550,440
20160030,662,709,841,869,862,1606,5549,441
20160405,606,737,854,888,890,1574,5549,442
20160716,746,762,816,850,823,1552,5549,443
20160923,691,724,742,897,886,1608,5548,444
20160448,723,759,733,887,867,1578,5547,445
20160484,669,720,821,893,827,1617,5547,446
20160190,702,712,840,867,905,1519,5545,447
20162025,725,764,810,883,850,1512,5544,448
20161045,737,735,817,881,883,1488,5541,449
20160436,527,657,861,917,936,1642,5540,450
20160301,682,703,784,876,885,1609,5539,451
20160902,728,741,828,839,867,1535,5538,452
20160943,767,775,763,859,853,1521,5538,453
20161085,506,689,868,896,922,1657,5538,454
20160377,750,787,887,877,756,1480,5537,455
20161113,564,715,832,899,917,1610,5537,456
20160487,657,686,828,896,887,1582,5536,457
20161842,650,669,783,890,905,1638,5535,458
20160471,728,744,833,866,845,1517,5533,459
20160011,691,709,830,873,853,1576,5532,460
20160838,710,765,779,873,867,1538,5532,461
20160660,716,697,805,874,886,1553,5531,462
20160709,645,740,844,854,886,1560,5529,463
20160416,702,728,828,866,868,1535,5527,464
20161942,679,669,847,893,860,1579,5527,465
20160286,647,710,828,881,869,1591,5526,466
20160502,739,777,799,876,835,1500,5526,467
20160398,630,679,847,855,895,1619,5525,468
20160283,626,688,794,869,910,1635,5522,469
20160278,706,731,820,854,875,1530,5516,470
20160578,657,752,813,897,839,1558,5516,471
20161900,635,728,783,887,915,1567,5515,472
20160327,721,767,788,886,821,1531,5514,473
20160300,746,769,833,905,776,1483,5512,474
20160418,670,704,765,872,912,1587,5510,475
20160520,706,718,791,859,841,1593,5508,476
20160747,772,810,889,882,727,1428,5508,477
20160613,652,759,767,829,889,1610,5506,478
20160765,506,785,859,881,873,1602,5506,479
20160668,705,706,724,892,889,1589,5505,480
20160522,662,762,803,867,818,1592,5504,481
20160277,612,670,829,908,908,1575,5502,482
20161924,606,739,775,901,869,1611,5501,483
20160061,625,704,806,871,894,1598,5498,484
20160133,630,732,800,862,865,1609,5498,485
20160601,634,682,756,917,908,1600,5497,486
20160240,734,731,717,913,871,1529,5495,487
20161824,541,697,843,883,922,1607,5493,488
20161818,700,699,823,860,831,1578,5491,489
20160455,609,694,788,883,888,1628,5490,490
20160038,721,731,847,884,782,1521,5486,491
20160144,690,752,818,856,857,1513,5486,492
20160272,718,775,804,893,799,1497,5486,493
20160785,691,763,813,854,828,1537,5486,494
20161935,631,763,741,869,869,1612,5485,495
20160303,635,727,813,885,854,1570,5484,496
20160930,703,708,803,863,842,1565,5484,497
20161923,699,741,847,816,823,1558,5484,498
20160584,695,700,849,868,827,1543,5482,499
20160665,684,740,841,885,814,1517,5481,500
20160708,680,734,733,860,863,1611,5481,501
20160494,676,680,770,861,888,1604,5479,502
20160145,617,639,804,878,914,1625,5477,503
20161941,589,655,845,890,940,1558,5477,504
20160669,679,703,755,893,858,1588,5476,505
20160650,646,720,834,867,867,1537,5471,506
20161833,597,722,867,877,774,1634,5471,507
20160407,755,783,857,847,762,1466,5470,508
20160343,690,733,742,883,911,1508,5467,509
20160124,644,733,837,863,840,1548,5465,510
20160115,645,705,775,897,868,1574,5464,511
20160182,732,775,837,840,825,1454,5463,512
20160024,711,739,777,856,810,1569,5462,513
20160396,621,725,834,852,873,1553,5458,514
20160887,670,744,773,857,860,1553,5457,515
20160512,703,675,732,865,878,1603,5456,516
20160125,596,718,806,883,841,1611,5455,517
20161837,601,657,803,903,896,1593,5453,518
20160324,637,738,834,867,859,1515,5450,519
20160803,642,675,806,855,872,1600,5450,520
20160214,651,720,770,894,850,1564,5449,521
20160811,645,714,799,858,850,1582,5448,522
20160025,715,659,709,855,869,1640,5447,523
20160692,534,678,758,888,925,1664,5447,524
20160110,681,752,812,875,774,1552,5446,525
20160164,672,715,750,866,851,1590,5444,526
20160535,597,720,796,893,874,1564,5444,527
20160783,624,721,759,823,885,1631,5443,528
20160160,660,697,802,883,867,1532,5441,529
20160936,687,693,786,884,872,1519,5441,530
20160631,699,680,740,851,839,1630,5439,531
20162026,739,669,806,874,822,1529,5439,532
20161073,652,723,779,869,842,1573,5438,533
20160641,712,722,813,881,800,1509,5437,534
20161902,667,711,761,878,872,1545,5434,535
20160461,695,796,849,862,780,1451,5433,536
20160250,703,707,781,897,835,1508,5431,537
20160460,672,730,777,889,853,1510,5431,538
20161839,684,731,817,792,814,1592,5430,539
20160158,630,692,788,865,862,1591,5428,540
20160548,723,768,760,882,847,1447,5427,541
20160199,688,735,790,844,863,1506,5426,542
20160104,522,682,831,912,884,1594,5425,543
20160886,668,682,816,862,889,1507,5424,544
20161841,634,549,872,864,905,1600,5424,545
20160259,677,668,784,849,867,1577,5422,546
20160266,737,780,890,891,728,1396,5422,547
20160977,540,728,805,864,908,1576,5421,548
20161080,657,722,782,889,896,1474,5420,549
20160035,612,670,826,845,858,1608,5419,550
20160568,691,715,758,860,846,1549,5419,551
20160509,591,689,819,869,877,1572,5417,552
20160567,737,736,791,840,824,1489,5417,553
20160598,680,715,704,878,879,1561,5417,554
20160500,686,741,758,853,853,1523,5414,555
20161937,660,735,787,843,866,1523,5414,556
20160264,704,741,774,863,790,1541,5413,557
20162037,616,710,788,907,868,1522,5411,558
20160256,512,673,803,899,892,1631,5410,559
20160312,762,807,869,839,708,1425,5410,560
20160481,644,709,762,856,849,1590,5410,561
20161840,634,777,855,851,774,1515,5406,562
20160552,661,679,827,798,830,1607,5402,563
20161920,664,737,780,856,840,1525,5402,564
20160127,521,662,808,909,889,1612,5401,565
20160226,643,720,649,895,892,1602,5401,566
20161827,695,749,854,788,777,1537,5400,567
20160402,668,709,784,864,835,1539,5399,568
20161082,551,717,877,759,815,1678,5397,569
20160458,623,688,806,852,844,1578,5391,570
20160374,587,593,748,921,920,1621,5390,571
20161090,695,691,762,856,815,1571,5390,572
20162049,709,714,790,827,814,1529,5383,573
20160350,577,702,742,881,887,1593,5382,574
20160217,718,731,715,857,827,1532,5380,575
20160449,543,728,760,878,875,1596,5380,576
20160696,613,669,803,886,841,1568,5380,577
20160091,722,762,779,827,787,1502,5379,578
20160216,677,701,710,897,909,1485,5379,579
20162070,692,630,748,882,863,1564,5379,580
20160329,675,695,768,861,827,1551,5377,581
20161091,610,696,803,887,874,1507,5377,582
20160062,686,756,815,878,826,1415,5376,583
20161844,657,641,823,875,860,1520,5376,584
20161928,637,745,811,849,821,1513,5376,585
20162090,671,610,770,873,869,1578,5371,586
20160297,737,745,787,837,788,1475,5369,587
20160413,724,741,733,852,832,1486,5368,588
20160622,722,731,792,859,774,1490,5368,589
20160723,507,665,806,897,896,1597,5368,590
20160498,664,718,747,863,853,1520,5365,591
20160014,759,731,793,860,765,1456,5364,592
20160051,686,717,808,856,822,1475,5364,593
20160671,690,685,727,881,844,1537,5364,594
20160647,645,698,737,855,880,1546,5361,595
20160349,582,659,747,881,907,1584,5360,596
20160517,685,693,747,849,830,1556,5360,597
20162084,548,681,792,900,900,1538,5359,598
20160574,633,632,766,847,894,1585,5357,599
20160233,596,690,755,862,867,1586,5356,600
20161120,608,703,818,902,825,1500,5356,601
20160109,676,683,789,861,845,1501,5355,602
20160113,613,700,743,868,842,1589,5355,603
20160206,614,681,708,875,883,1594,5355,604
20160055,655,705,729,856,844,1564,5353,605
20160661,751,781,818,849,713,1439,5351,606
20160531,721,725,794,828,760,1519,5347,607
20160857,699,745,818,857,759,1468,5346,608
20161807,539,573,815,884,909,1626,5346,609
20160750,650,726,786,822,843,1518,5345,610
20161826,648,705,842,852,811,1487,5345,611
20161936,561,729,720,859,862,1614,5345,612
20160549,697,691,750,844,852,1510,5344,613
20161830,578,619,833,875,870,1567,5342,614
20160313,621,696,755,881,835,1552,5340,615
20160735,689,633,770,852,839,1554,5337,616
20160171,670,654,701,881,893,1538,5337,617
20160683,643,670,765,840,846,1572,5336,618
20160974,725,718,672,830,804,1585,5334,619
20160058,745,747,833,818,804,1386,5333,620
20160376,606,711,778,857,819,1562,5333,621
20160693,614,688,748,856,870,1557,5333,622
20160021,693,660,768,887,810,1512,5330,623
20160197,645,688,778,857,790,1567,5325,624
20160203,537,740,806,847,869,1525,5324,625
20160590,632,730,830,823,804,1503,5322,626
20160810,597,667,686,859,887,1626,5322,627
20162089,722,702,699,833,854,1512,5322,628
20160118,744,747,787,833,796,1414,5321,629
20160652,720,706,731,807,770,1586,5320,630
20150143,535,639,787,884,894,1581,5320,631
20160268,634,710,773,860,829,1512,5318,632
20160022,606,686,751,881,846,1546,5316,633
20160059,695,693,737,844,839,1508,5316,634
20160672,637,679,746,869,849,1536,5316,635
20150007,528,561,784,878,900,1665,5316,636
20161828,636,630,818,837,819,1575,5315,637
20160612,700,655,728,875,848,1508,5314,638
20161823,595,696,828,851,819,1525,5314,639
20160351,648,686,778,850,835,1514,5311,640
20160718,655,675,746,852,871,1512,5311,641
20162057,607,659,784,872,845,1542,5309,642
20160397,670,684,723,866,812,1553,5308,643
20160825,635,680,736,830,871,1556,5308,644
20160939,671,661,703,872,825,1575,5307,645
20161853,605,715,838,834,821,1494,5307,646
20160446,501,639,756,899,891,1620,5306,647
20160695,564,667,723,807,878,1665,5304,648
20160859,702,710,737,806,830,1519,5304,649
20161918,609,729,880,773,862,1450,5303,650
20160098,664,677,808,827,795,1528,5299,651
20161094,517,692,805,857,860,1567,5298,652
20160427,600,668,713,859,863,1591,5294,653
20160780,694,694,741,829,820,1516,5294,654
20160036,664,637,716,846,860,1570,5293,655
20161812,514,614,865,866,896,1538,5293,656
20162043,602,671,757,834,884,1544,5292,657
20161917,661,751,716,833,881,1447,5289,658
20160682,629,648,769,858,865,1519,5288,659
20161075,575,670,757,877,886,1522,5287,660
20160076,522,627,763,878,873,1623,5286,661
20160210,740,702,714,830,749,1550,5285,662
20160704,518,593,740,847,922,1660,5280,663
20162092,560,707,764,870,802,1577,5280,664
20160260,592,601,730,888,856,1612,5279,665
20160881,641,630,700,881,869,1557,5278,666
20160043,639,641,747,889,854,1506,5276,667
20162012,680,629,761,836,835,1531,5272,668
20160175,629,713,703,844,796,1586,5271,669
20161919,617,747,678,858,864,1506,5270,670
20160441,735,746,686,832,797,1473,5269,671
20160357,623,686,736,881,824,1517,5267,672
20160073,601,689,796,840,830,1510,5266,673
20160724,640,667,744,840,838,1536,5265,674
20160045,748,758,709,745,775,1528,5263,675
20160726,552,807,810,765,749,1580,5263,676
20150279,517,629,763,898,912,1542,5261,677
20160317,596,643,789,866,842,1522,5258,678
20160518,653,667,753,751,862,1572,5258,679
20160873,673,652,708,830,866,1527,5256,680
20160566,571,595,735,840,894,1620,5255,681
20150352,670,633,608,874,923,1547,5255,682
20160337,553,685,773,804,867,1569,5251,683
20160513,494,724,786,826,823,1598,5251,684
20160013,697,689,791,799,767,1505,5248,685
20150179,672,692,612,876,839,1557,5248,686
20162042,586,678,781,870,876,1457,5248,687
20160713,606,630,736,889,881,1502,5244,688
20161804,646,716,751,810,818,1501,5242,689
20161801,563,639,813,849,787,1590,5241,690
20161143,533,648,803,883,852,1521,5240,691
20160715,685,631,787,857,788,1491,5239,692
20160624,617,681,758,848,755,1578,5237,693
20160433,609,627,747,853,830,1570,5236,694
20160569,724,732,723,815,756,1486,5236,695
20160979,599,703,738,855,856,1483,5234,696
20160728,687,700,796,825,751,1472,5231,697
20161803,729,680,798,772,760,1492,5231,698
20160876,700,696,760,830,816,1425,5227,699
20160237,639,674,743,813,790,1567,5226,700
20160714,700,636,667,835,830,1557,5225,701
20160304,534,657,699,852,868,1609,5219,702
20160756,755,622,696,880,792,1472,5217,703
20161800,604,686,772,851,828,1476,5217,704
20160848,717,693,814,862,828,1302,5216,705
20160305,683,718,739,833,749,1493,5215,706
20160821,723,691,619,822,884,1475,5214,707
20160537,647,723,801,875,731,1434,5211,708
20160918,626,707,728,834,828,1486,5209,709
20160409,609,731,675,816,802,1575,5208,710
20160636,683,705,720,843,782,1472,5205,711
20160129,568,724,704,860,840,1508,5204,712
20160685,665,717,775,763,778,1506,5204,713
20160457,669,680,716,854,820,1464,5203,714
20160779,550,562,763,844,872,1612,5203,715
20160778,582,584,677,843,898,1614,5198,716
20160232,690,714,702,837,781,1471,5195,717
20162036,673,665,700,877,778,1501,5194,718
20160314,575,643,754,857,853,1511,5193,719
20160712,612,621,722,869,844,1524,5192,720
20161850,601,719,829,891,773,1379,5192,721
20160348,737,704,680,713,814,1543,5191,722
20160486,589,675,658,812,866,1589,5189,723
20152075,638,692,612,848,874,1525,5189,724
20160371,576,683,748,825,835,1518,5185,725
20160034,665,661,704,799,762,1593,5184,726
20160763,619,585,741,878,763,1597,5183,727
20161806,633,633,775,848,781,1513,5183,728
20161932,707,720,872,884,646,1354,5183,729
20160633,641,677,652,838,832,1542,5182,730
20160782,639,554,736,877,829,1547,5182,731
20161121,548,671,800,864,773,1526,5182,732
20160042,652,670,673,803,845,1536,5179,733
20160063,723,697,824,805,741,1389,5179,734
20160628,562,546,729,860,866,1615,5178,735
20160985,534,595,767,855,872,1555,5178,736
20160353,641,664,740,842,757,1533,5177,737
20160730,627,658,708,821,858,1502,5174,738
20160510,597,628,719,842,833,1554,5173,739
20140965,557,547,820,826,852,1570,5172,740
20160057,565,673,742,850,843,1497,5170,741
20140647,561,574,726,816,850,1643,5170,742
20160619,611,727,678,868,768,1517,5169,743
20161825,620,701,845,841,742,1420,5169,744
20160956,608,686,742,844,849,1434,5163,745
20161107,587,681,725,786,811,1573,5163,746
20160404,693,648,695,851,805,1467,5159,747
20162011,589,657,780,872,741,1516,5155,748
20162013,596,657,733,892,786,1491,5155,749
20160545,634,687,758,812,722,1540,5153,750
20162039,695,746,752,874,762,1323,5152,751
20161817,533,674,837,860,822,1424,5150,752
20160016,647,683,723,875,812,1408,5148,753
20160064,690,647,771,809,778,1453,5148,754
20160112,536,619,658,863,869,1602,5147,755
20160393,579,605,760,847,835,1521,5147,756
20160721,572,614,669,851,867,1574,5147,757
20160858,673,677,761,867,791,1378,5147,758
20160093,530,633,738,869,841,1533,5144,759
20160386,656,683,761,765,799,1480,5144,760
20160629,575,653,738,844,810,1523,5143,761
20160877,599,623,754,784,825,1558,5143,762
20160425,635,653,707,825,805,1517,5142,763
20160047,684,703,719,784,777,1474,5141,764
20161069,500,743,752,870,819,1455,5139,765
20160048,645,747,874,869,729,1271,5135,766
20160121,570,645,739,888,796,1496,5134,767
20160504,607,683,743,826,802,1468,5129,768
20160044,583,642,743,860,825,1472,5125,769
20160126,728,693,653,821,820,1409,5124,770
20160084,618,730,724,813,776,1462,5123,771
20160544,577,682,786,860,761,1457,5123,772
20160580,496,538,654,882,901,1651,5122,773
20160389,506,542,773,897,887,1514,5119,774
20160467,512,641,690,878,838,1560,5119,775
20161846,578,658,790,871,801,1421,5119,776
20160439,541,628,747,861,825,1512,5114,777
20160658,662,628,721,857,800,1442,5110,778
20160362,592,639,681,826,829,1541,5108,779
20160004,568,644,766,861,818,1447,5104,780
20160184,588,613,708,811,833,1551,5104,781
20160729,734,701,671,823,779,1394,5102,782
20161938,599,662,808,854,753,1420,5096,783
20161848,646,707,755,785,760,1442,5095,784
20161834,596,614,722,809,831,1511,5083,785
20160430,602,685,713,822,740,1520,5082,786
20160734,596,579,681,813,857,1555,5081,787
20151058,506,550,703,870,872,1579,5080,788
20160595,541,612,653,848,860,1565,5079,789
20160298,711,690,636,746,758,1537,5078,790
20160077,639,629,697,823,764,1523,5075,791
20160111,658,657,611,792,808,1545,5071,792
20160770,631,715,701,797,812,1414,5070,793
20160201,578,573,655,865,856,1541,5068,794
20161035,580,760,779,847,729,1373,5068,795
20160654,581,627,656,847,825,1531,5067,796
20161040,670,598,717,777,815,1488,5065,797
20160288,596,610,688,839,783,1548,5064,798
20151082,641,622,617,824,867,1491,5062,799
20160379,658,671,680,758,829,1459,5055,800
20160775,679,600,665,778,841,1492,5055,801
20160180,502,567,812,866,877,1425,5049,802
20160369,613,736,790,792,764,1353,5048,803
20160218,634,647,714,833,736,1475,5039,804
20160265,620,622,609,802,815,1571,5039,805
20160370,616,655,634,839,851,1443,5038,806
20160699,534,604,743,819,832,1506,5038,807
20160157,636,677,668,816,753,1486,5036,808
20160667,572,688,688,846,818,1422,5034,809
20150172,516,579,586,903,885,1565,5034,810
20140172,503,574,671,871,887,1528,5034,811
20160659,639,648,715,783,769,1479,5033,812
20160572,647,536,698,863,809,1479,5032,813
20160736,623,659,725,779,772,1474,5032,814
20160456,529,562,633,880,840,1587,5031,815
20162017,555,590,708,851,819,1505,5028,816
20161934,664,742,680,703,780,1457,5026,817
20160373,588,663,670,834,774,1496,5025,818
20160296,696,566,718,795,728,1520,5023,819
20160159,518,664,699,856,787,1495,5019,820
20160593,700,654,659,834,691,1480,5018,821
20160173,676,681,747,756,699,1458,5017,822
20160316,522,690,715,832,845,1413,5017,823
20160236,663,686,643,802,759,1463,5016,824
20161911,711,722,690,788,715,1390,5016,825
20160812,584,660,680,756,783,1550,5013,826
20160749,492,546,707,864,869,1530,5008,827
20160285,571,641,773,820,767,1435,5007,828
20160758,683,671,683,798,668,1503,5006,829
20160189,566,638,793,779,797,1432,5005,830
20161849,536,577,740,867,830,1455,5005,831
20160310,520,611,729,879,775,1489,5003,832
20160897,541,607,669,826,825,1535,5003,833
20160966,589,669,799,802,759,1385,5003,834
20160267,650,545,664,871,798,1474,5002,835
20160033,561,655,674,810,773,1528,5001,836
20162048,604,659,712,825,768,1433,5001,837
20160928,647,612,669,825,772,1475,5000,838
20160530,518,575,786,852,751,1514,4996,839
20161940,579,659,706,863,733,1452,4992,840
20160248,512,585,722,831,814,1526,4990,841
20160186,742,654,650,782,742,1419,4989,842
20160527,600,664,642,807,781,1494,4988,843
20160335,573,578,622,799,897,1518,4987,844
20151151,631,699,806,712,648,1490,4986,845
20160739,503,609,793,830,792,1458,4985,846
20160273,553,640,613,861,808,1507,4982,847
20160557,570,573,617,844,838,1540,4982,848
20160149,508,613,786,850,793,1430,4980,849
20160020,632,571,639,778,850,1509,4979,850
20160819,555,578,716,824,835,1471,4979,851
20162074,646,725,785,739,740,1343,4978,852
20162077,578,671,703,803,803,1417,4975,853
20160440,611,644,703,781,748,1486,4973,854
20160454,525,643,752,840,805,1408,4973,855
20161808,558,681,714,826,726,1468,4973,856
20160403,532,642,716,854,765,1463,4972,857
20160963,539,654,714,796,836,1429,4968,858
20161155,527,603,670,828,819,1521,4968,859
20161802,575,700,749,758,637,1548,4967,860
20160074,520,567,636,826,828,1588,4965,861
20160056,547,644,655,803,813,1499,4961,862
20160141,560,732,804,825,718,1319,4958,863
20160423,525,716,715,713,796,1488,4953,864
20161102,534,654,700,811,798,1456,4953,865
20160861,542,626,754,836,740,1454,4952,866
20160488,513,575,688,855,805,1515,4951,867
20160573,622,615,626,847,786,1453,4949,868
20160555,542,553,728,874,846,1400,4943,869
20161150,512,630,703,831,803,1464,4943,870
20160434,552,639,672,837,774,1468,4942,871
20160856,530,602,703,839,757,1511,4942,872
20160711,635,698,690,811,729,1378,4941,873
20160904,505,619,676,863,793,1479,4935,874
20160524,620,658,735,682,677,1562,4934,875
20160626,509,569,671,814,799,1571,4933,876
20160192,528,570,738,788,824,1484,4932,877
20150857,623,561,828,769,759,1385,4925,878
20160050,627,708,737,827,731,1291,4921,879
20160120,531,625,695,812,761,1495,4919,880
20161084,487,642,702,837,788,1463,4919,881
20160490,584,713,745,809,736,1329,4916,882
20162001,530,528,650,823,811,1571,4913,883
20160565,694,780,828,831,608,1170,4911,884
20160616,693,699,701,774,664,1378,4909,885
20160169,545,671,748,810,782,1351,4907,886
20161158,553,620,679,774,804,1476,4906,887
20160900,659,646,685,794,767,1351,4902,888
20160336,625,604,659,780,809,1424,4901,889
20160263,644,681,777,776,693,1329,4900,890
20160485,551,600,612,841,814,1482,4900,891
20151081,626,587,673,787,805,1422,4900,892
20160344,544,572,758,816,796,1413,4899,893
20150811,505,529,624,838,833,1566,4895,894
20160776,608,654,613,819,739,1460,4893,895
20151140,518,723,771,791,739,1348,4890,896
20161076,597,630,719,787,769,1387,4889,897
20150418,487,568,593,877,811,1553,4889,898
20160617,499,707,699,805,777,1401,4888,899
20161043,550,659,639,755,783,1496,4882,900
20161140,523,629,682,792,785,1468,4879,901
20160215,535,601,636,828,797,1480,4877,902
20150061,506,550,640,846,819,1515,4876,903
20160837,589,696,741,773,720,1356,4875,904
20162067,505,544,657,859,910,1399,4874,905
20160731,518,631,654,798,813,1459,4873,906
20160801,535,598,731,759,784,1466,4873,907
20151164,549,612,659,808,811,1434,4873,908
20160839,611,722,731,787,709,1312,4872,909
20160581,666,668,675,786,702,1374,4871,910
20160851,585,604,707,834,841,1299,4870,911
20161160,618,659,714,745,751,1382,4869,912
20161135,524,617,657,857,772,1438,4865,913
20160194,507,599,716,822,785,1435,4864,914
20160855,573,595,611,821,777,1481,4858,916
20160023,532,607,698,776,745,1498,4856,917
20150734,564,549,581,794,842,1522,4852,918
20160388,573,669,685,795,743,1383,4848,919
20160412,522,577,690,819,767,1468,4843,920
20160769,526,535,743,748,729,1561,4842,921
20160808,496,548,671,800,797,1529,4841,922
20150554,639,662,593,816,722,1408,4840,923
20160208,551,633,727,851,701,1372,4835,924
20160340,543,627,653,828,784,1399,4834,925
20161106,504,594,666,791,808,1470,4833,926
20150548,572,553,620,820,727,1540,4832,927
20160143,515,581,644,781,788,1522,4831,928
20160151,539,631,698,800,787,1376,4831,929
20160275,691,601,619,718,709,1492,4830,930
20160814,506,601,704,794,744,1477,4826,931
20160655,561,561,690,784,799,1428,4823,932
20160744,537,583,607,776,808,1507,4818,933
20161805,569,552,694,832,803,1367,4817,934
20160623,656,560,640,828,695,1437,4816,935
20161105,535,591,641,753,826,1469,4815,936
20150159,497,528,632,823,846,1488,4814,937
20150030,518,602,663,826,727,1476,4812,938
20160291,528,694,716,749,712,1412,4811,939
20160307,574,570,726,937,741,1263,4811,940
20140620,501,541,614,828,860,1466,4810,941
20160462,501,546,611,801,780,1570,4809,942
20160187,575,605,702,788,706,1431,4807,943
20160450,550,552,588,881,815,1420,4806,944
20160815,573,677,607,774,711,1463,4805,945
20160602,500,575,618,746,810,1550,4799,946
20160805,524,577,661,772,805,1460,4799,947
20160081,530,574,626,785,756,1525,4796,948
20161813,499,601,713,811,724,1448,4796,949
20161061,490,558,683,851,795,1418,4795,950
20160372,547,583,604,795,790,1472,4791,951
20161065,578,679,670,806,708,1345,4786,952
20160352,531,586,639,829,772,1428,4785,953
20160411,538,613,639,788,751,1453,4782,954
20151748,673,734,601,752,735,1287,4782,955
20150356,500,544,663,800,791,1482,4780,956
20161112,500,579,679,794,796,1430,4778,957
20161152,539,608,692,744,753,1437,4773,958
20160363,521,668,646,806,717,1413,4771,959
20140119,502,548,602,828,834,1457,4771,960
20160420,604,622,706,741,647,1450,4770,961
20161095,549,550,728,793,722,1428,4770,962
20160511,514,590,681,843,790,1349,4767,963
20160842,529,571,611,801,856,1396,4764,964
20161083,528,629,739,793,704,1368,4761,965
20160394,572,616,678,812,739,1342,4759,966
20161188,620,636,707,772,743,1264,4742,967
20160204,619,612,777,800,743,1190,4741,968
20160212,523,634,685,784,707,1408,4741,969
20160229,506,563,687,846,811,1349,4762,970
20160375,504,605,647,808,756,1442,4762,971
20160609,510,560,653,786,801,1448,4758,972
20160868,515,602,624,811,787,1417,4756,973
20160817,588,614,678,742,755,1378,4755,974
20161012,526,557,668,834,783,1381,4749,975
20160719,502,533,659,789,831,1417,4731,976
20160002,533,555,654,752,774,1459,4727,977
20160543,576,652,622,757,701,1417,4725,978
20160060,511,605,616,805,723,1464,4724,979
20130246,506,584,669,851,765,1345,4720,980
20160191,625,592,692,787,731,1291,4718,981
20161081,491,603,598,830,750,1445,4717,982
20141347,513,559,592,828,855,1370,4717,983
20160933,499,537,709,812,685,1473,4715,984
20160138,599,588,693,810,655,1369,4714,985
20150750,504,543,635,833,707,1492,4714,986
20140494,510,536,613,796,794,1461,4710,987
2012471,518,537,705,838,769,1343,4710,988
20160501,488,541,596,766,789,1528,4708,989
20121182,494,524,600,823,850,1417,4708,990
20140549,489,550,630,819,786,1432,4706,991
20140437,527,546,622,788,813,1409,4705,992
20160117,508,611,603,764,787,1428,4701,993
20160174,558,553,613,755,768,1454,4701,994
20160702,686,541,616,862,831,1164,4700,995
20160774,551,586,615,858,710,1372,4692,996
20150852,506,538,653,809,784,1402,4692,997
20161020,574,582,668,791,720,1356,4691,998
20150728,529,558,612,782,756,1453,4690,999
20160599,539,580,625,758,747,1438,4687,1000
20151106,524,558,628,771,784,1421,4686,1001
20161097,500,559,633,757,709,1527,4685,1002
20140498,488,536,642,810,721,1487,4684,1003
20150144,504,587,622,802,708,1460,4683,1004
20161055,517,550,643,782,765,1423,4680,1005
20160915,741,717,654,762,712,1090,4676,1006
20161049,585,604,645,762,715,1365,4676,1007
20151125,514,523,629,797,778,1435,4676,1008
20160252,576,690,666,739,731,1273,4675,1009
20160965,513,536,644,792,795,1394,4674,1010
20160991,501,543,608,832,803,1385,4672,1011
20150742,504,535,614,813,790,1416,4672,1012
20161187,523,597,708,770,712,1354,4664,1013
20150297,528,559,599,820,721,1433,4660,1014
20161096,513,561,621,750,695,1518,4658,1015
20160172,566,593,631,783,675,1408,4656,1016
20160287,524,590,617,766,770,1369,4636,1017
20150754,492,541,599,813,778,1413,4636,1018
20160342,512,534,602,797,757,1429,4631,1019
20160052,695,599,593,759,747,1237,4630,1020
20160541,608,572,592,707,704,1446,4629,1021
20160005,524,585,607,739,698,1473,4626,1022
20151007,530,560,717,805,648,1365,4625,1023
20150988,514,555,663,735,759,1396,4622,1024
20151052,515,560,599,817,798,1328,4617,1025
20160150,502,561,645,805,742,1359,4614,1026
20160040,559,539,675,753,670,1417,4613,1027
20160852,506,560,618,859,760,1306,4609,1028
20160444,485,537,630,761,769,1426,4608,1029
20160738,636,606,606,772,728,1259,4607,1030
20160525,623,667,656,835,639,1186,4606,1031
20161154,513,650,718,799,670,1251,4601,1032
20160346,506,540,590,762,752,1448,4598,1033
2013202,518,625,614,660,779,1401,4597,1034
20161183,500,566,618,767,742,1403,4596,1035
20160097,650,640,644,692,645,1324,4595,1036
20161182,503,555,655,743,722,1414,4592,1037
20150844,512,550,599,732,744,1454,4591,1038
20160994,494,576,763,733,732,1292,4590,1039
20161165,509,592,647,792,698,1350,4588,1040
20162016,627,620,669,688,619,1365,4588,1041
20160793,514,576,619,708,724,1444,4585,1042
20160332,492,543,650,787,779,1333,4584,1043
20151093,495,543,581,832,807,1324,4582,1044
20161109,594,579,617,776,703,1308,4577,1045
20150602,596,563,588,716,694,1419,4576,1046
20131186,495,520,593,844,776,1346,4574,1047
20140600,589,574,657,701,685,1363,4569,1048
20160532,577,553,599,777,738,1324,4568,1049
20161133,551,544,637,715,746,1372,4565,1050
20160341,584,522,625,736,755,1340,4562,1051
20160414,559,583,642,719,733,1326,4562,1052
20150402,538,538,646,781,653,1405,4561,1053
20140780,496,550,600,795,673,1445,4559,1054
20151034,489,535,673,799,740,1321,4557,1055
20161118,513,573,625,777,743,1321,4552,1056
20150191,496,528,633,836,750,1309,4552,1057
2013803,518,538,609,787,729,1371,4552,1058
20140685,492,553,633,762,704,1407,4551,1059
20162101,502,530,633,724,779,1382,4550,1060
20161038,537,546,653,783,693,1335,4547,1061
20151063,488,543,594,792,780,1350,4547,1062
20141475,530,548,665,811,654,1339,4547,1063
20160998,508,575,604,786,733,1340,4546,1064
20161100,621,640,763,744,648,1129,4545,1065
20160299,495,532,661,803,743,1307,4541,1066
20160088,551,538,601,709,762,1376,4537,1067
20160167,514,528,616,763,712,1401,4534,1068
20140544,491,536,593,675,774,1463,4532,1069
2013488,515,533,599,783,718,1383,4531,1070
20161087,600,633,610,760,660,1266,4529,1071
20161170,495,565,636,723,765,1345,4529,1072
20160085,500,551,612,777,696,1387,4523,1073
20160753,521,557,618,732,687,1408,4523,1074
20160224,501,541,646,756,649,1429,4522,1075
20131182,498,543,652,834,791,1198,4516,1076
20160528,555,582,590,710,711,1366,4514,1077
20160134,598,569,647,812,653,1233,4512,1078
20151172,547,524,650,802,701,1288,4512,1079
20160794,537,632,672,717,648,1305,4511,1080
20150132,528,532,596,736,693,1423,4508,1081
20141141,490,530,618,784,758,1326,4506,1082
20160820,492,526,641,761,743,1342,4505,1083
20162021,624,596,595,770,711,1205,4501,1084
2013489,510,538,616,786,714,1332,4496,1085
20150971,549,604,612,733,622,1375,4495,1086
20161110,500,537,615,753,724,1365,4494,1087
20131714,588,624,712,663,615,1292,4494,1088
20160140,548,592,651,733,662,1305,4491,1089
20161127,507,568,640,736,711,1329,4491,1090
20141126,487,526,599,807,751,1317,4487,1091
20160183,634,622,658,609,642,1316,4481,1092
20160147,517,532,589,764,701,1376,4479,1093
20141424,503,548,598,804,730,1292,4475,1095
20160489,517,581,640,705,704,1327,4474,1097
20162100,503,572,586,731,737,1343,4472,1098
20150404,513,538,606,755,692,1364,4468,1099
20160999,500,529,612,681,769,1372,4463,1100
20141157,516,552,596,595,750,1449,4458,1101
20141468,560,561,622,697,692,1325,4457,1102
20160315,579,560,617,736,660,1304,4456,1103
20161189,490,610,631,741,665,1315,4452,1104
20131302,501,536,604,726,714,1367,4448,1105
20140195,500,535,617,715,723,1357,4447,1106
20141304,495,538,584,690,756,1382,4445,1107
20150389,550,512,617,813,678,1270,4440,1108
20161184,509,604,592,752,691,1289,4437,1109
20141476,509,525,604,788,684,1324,4434,1110
2002850850,524,561,614,673,661,1398,4431,1111
20162069,737,669,595,655,600,1173,4429,1112
20160836,545,540,596,739,672,1333,4425,1113
20150560,517,524,608,741,762,1271,4423,1114
20140457,495,527,616,784,728,1267,4417,1115
20150090,512,550,597,774,713,1267,4413,1116
20160424,596,597,615,702,615,1286,4411,1117
20150946,513,540,587,721,738,1308,4407,1118
20161041,525,540,596,702,663,1380,4406,1119
20150941,519,567,658,751,682,1225,4402,1120
20161811,554,611,741,753,609,1131,4399,1121
20161010,596,661,611,619,633,1273,4393,1122
20150610,550,565,690,676,646,1265,4392,1123
20140646,498,522,577,784,740,1270,4391,1124
2009901697,564,695,614,640,709,1168,4390,1125
20150130,494,520,586,793,712,1284,4389,1126
20150981,533,537,619,721,660,1316,4386,1127
20141345,507,547,590,614,797,1329,4384,1128
2012560,502,542,597,674,725,1343,4383,1129
20160202,495,543,589,681,676,1396,4380,1130
20161157,520,572,611,699,658,1318,4378,1131
20140547,486,531,623,695,694,1346,4375,1132
20160477,511,548,621,647,650,1388,4365,1133
20162086,540,583,641,805,629,1167,4365,1134
20160116,694,605,582,624,697,1160,4362,1135
20140434,501,554,607,712,687,1296,4357,1136
20160990,517,593,625,721,653,1247,4356,1137
20140843,550,548,592,759,652,1255,4356,1138
20111355,518,538,596,724,654,1326,4356,1139
20161123,505,542,599,680,661,1365,4352,1140
20160156,485,615,664,686,660,1238,4348,1141
20140021,518,582,605,614,720,1309,4348,1142
20161181,530,539,606,769,613,1290,4347,1143
2013889,500,545,599,743,655,1302,4344,1144
2013221,494,532,651,776,731,1159,4343,1145
20141493,518,536,616,734,652,1284,4340,1146
2013443,489,530,592,676,703,1344,4334,1147
20161098,499,534,602,633,675,1386,4329,1149
20161171,501,554,575,709,697,1293,4329,1150
20121462,487,528,618,754,677,1265,4329,1151
20161026,547,528,614,658,724,1248,4319,1152
20161074,499,531,616,731,650,1287,4314,1153
2011373,537,553,593,772,624,1235,4314,1154
20150068,505,550,616,707,656,1276,4310,1155
20150809,533,575,591,762,651,1195,4307,1156
20141430,564,609,678,674,659,1120,4304,1157
20141303,512,539,634,713,653,1247,4298,1158
20151045,501,525,618,731,698,1223,4296,1159
20141279,486,535,583,742,641,1308,4295,1160
20141406,488,519,596,711,677,1303,4294,1161
201292,516,691,594,605,721,1158,4285,1163
20150917,502,536,631,705,609,1301,4284,1164
20140898,604,661,600,624,702,1088,4279,1165
2013236,482,531,575,775,734,1180,4277,1166
2001840118,589,620,727,563,697,1080,4276,1167
2013736,499,524,611,704,676,1260,4274,1168
20160790,512,519,587,607,682,1359,4266,1169
20161855,487,521,575,644,700,1336,4263,1170
20151037,516,567,613,690,604,1270,4260,1171
20160162,506,545,612,646,637,1312,4258,1172
20141470,507,523,581,721,697,1212,4241,1173
20140828,511,543,635,679,621,1248,4237,1174
20140299,493,531,603,742,682,1185,4236,1175
20140344,638,557,609,592,632,1204,4232,1176
20131403,493,544,609,747,640,1193,4226,1177
20151139,513,531,618,665,711,1187,4225,1178
20141049,524,536,591,689,700,1175,4215,1179
20150984,514,539,604,682,640,1235,4214,1180
20150987,545,591,600,681,648,1142,4207,1181
20140844,511,562,578,728,684,1142,4205,1182
20140537,499,522,589,709,647,1238,4204,1183
20141294,499,530,614,714,641,1204,4202,1184
20161124,515,557,577,710,619,1217,4195,1185
2012319,557,534,613,589,699,1200,4192,1186
20140765,509,546,668,716,652,1092,4183,1187
20152105,543,527,588,713,641,1167,4179,1188
20140763,518,544,604,764,646,1090,4166,1189
20160787,507,536,602,725,646,1145,4161,1190
20140239,501,541,577,707,678,1145,4149,1191
20141427,499,590,630,613,631,1185,4148,1192
20141464,503,529,588,685,632,1194,4131,1193
20141472,487,547,584,737,605,1155,4115,1194
20150036,506,544,580,743,621,1116,4110,1195
2002840906,516,532,608,634,648,1168,4106,1196
20131248,490,526,599,675,624,1184,4098,1197
20131211,502,532,595,711,622,1118,4080,1198
2013495,507,523,595,677,638,1138,4078,1199
2013651,518,529,588,622,690,1118,4065,1200
20141143,518,525,592,642,609,1176,4062,1201
2011975,527,545,617,581,624,1159,4053,1202
20111313,511,530,601,609,632,1167,4050,1203
20130697,506,524,596,603,653,1166,4048,1204
2007891216,487,524,602,632,648,1101,3994,1205
20142007,493,540,606,639,614,1086,3978,1206
2008910343,489,558,611,592,617,1093,3960,1207
20131073,508,545,588,615,600,1087,3943,1208